GOOBA by: 6ix9ine
goosebumps by: Travis Scott
Got It On Me by: Pop Smoke
GREECE (feat. Drake) by: DJ Khaled
Happier by: Marshmello
Hasta Que Dios Diga by: Anuel AA
Hate The Other Side (with Marshmello & The Kid Laroi) by: Juice WRLD
Hawái by: Maluma
Head & Heart (feat. MNEK) by: Joel Corry
Head Shoulders Knees & Toes (feat. Norma Jean Martine) by: Ofenbach
Heather by: Conan Gray
Hello (feat. A Boogie Wit da Hoodie) by: Pop Smoke
HIGHEST IN THE ROOM by: Travis Scott
Hit Different by: SZA
Holy (feat. Chance The Rapper) by: Justin Bieber
hot girl bummer by: blackbear
Hot Stuff by: Kygo
How You Like That by: BLACKPINK
I Don't Care (with Justin Bieber) by: Ed Sheeran
Ice Cream (with Selena Gomez) by: BLACKPINK
If the World Was Ending - feat. Julia Michaels by: JP Saxe
Ihr Hobby by: Bonez MC
ily (i love you baby) (feat. Emilee) by: Surf Mesa
In Your Eyes by: The Weeknd
Intentions (feat. Quavo) by: Justin Bieber
Investe Em Mim by: Jonas Esticado
Jangueo by: Alex Rose
Jeans by: Justin Quiles
Jerusalema (feat. Nomcebo Zikode) by: Master KG
Jocelyn Flores by: XXXTENTACION
July by: Noah Cyrus
Kings & Queens by: Ava Max
La Curiosidad by: Jay Wheeler
La Jeepeta - Remix by: Nio Garcia
La Tóxica by: Farruko
Laugh Now Cry Later (feat. Lil Durk) by: rak
Lean (feat. Towy, Osquel, Beltito & Sammy & Falsetto) by: Super Yei
Lemonade (feat. Gunna, Don Toliver & NAV) by: Internet Money
Let Her Go by: Passenger
Lets Link by: WhoHeem
Life Is Good (feat. Drake) by: Future
Lithuania (feat. Travis Scott) by: Big Sean
Lose Control by: MEDUZA
Lose Somebody by: Kygo
lovely (with Khalid) by: Billie Eilish
Lucid Dreams by: Juice WRLD
Mad at Disney by: salem ilese
Madrid by: Maluma
MAMACITA by: Black Eyed Peas
Mamichula - con Nicki Nicole by: Trueno
Mariposa by: Peach Tree Rascals
Martin & Gina by: Polo G
Me Gusta (with Cardi B & Myke Towers) by: Anitta
Memories by: Maroon 5
Mi Cuarto by: Jerry Di
Midnight Sky by: Miley Cyrus
MODUS by: oj
Money Trees by: Kendrick Lamar
Mood (feat. iann dior) by: 24kGoldn
Mood Swings (feat. Lil Tjay) by: Pop Smoke
Moonlight by: XXXTENTACION
my ex's best friend (with blackbear) by: Machine Gun Kelly
my future by: Billie Eilish
Máquina do Tempo by: Matuê
No Guidance (feat. Drake) by: Chris Brown
Nobody's Love by: Maroon 5
Not Shy by: ITZY
Oh Juliana by: Niack
OK Not To Be OK by: Marshmello
Over Now (with The Weeknd) by: Calvin Harris
Parce (feat. Justin Quiles) by: Maluma
Party Girl by: StaySolidRocky
Perfect by: Ed Sheeran
Physical by: Dua Lipa
Play Date by: Melanie Martinez
POPSTAR (feat. Drake) by: DJ Khaled
PORFA Remix ( Feat. Maluma, Nicky Jam, Sech) - Remix by: Feid
Pretty Boy (feat. Lil Yachty) by: Joji
Put Your Records On by: Ritt Momney
Quiéreme Mientras Se Pueda by: Manuel Turizo
Rain On Me (with Ariana Grande) by: Lady Gaga
Relación by: Sech
Relación - Remix by: Sech
Ride It by: Regard
Righteous by: Juice WRLD
RITMO (Bad Boys For Life) by: Black Eyed Peas
Robbery by: Juice WRLD
rockstar (feat. 21 Savage) by: Post Malone
ROCKSTAR (feat. Roddy Ricch) by: DaBaby
Rojo by: J Balvin
Roses - Imanbek Remix by: SAINt JHN
ROXANNE by: Arizona Zervas
Run by: Joji
SAD! by: XXXTENTACION
Safaera by: Bad Bunny
Sanctuary by: Joji
Savage Love (Laxed - Siren Beat) by: Jawsh 685
Savage Remix (feat. Beyoncé) by: Megan Thee Stallion
Say So by: Doja Cat
Say You Won't Let Go by: James Arthur
Se Te Nota (with Guaynaa) by: Lele Pons
Secrets by: Regard
September by: Earth, Wind & Fire
Señorita by: Shawn Mendes
Shallow by: Lady Gaga
Shape of You by: Ed Sheeran
SICKO MODE by: Travis Scott
SLOW DANCING IN THE DARK by: Joji
Smile (with The Weeknd) by: Juice WRLD
Some Say - Felix Jaehn Remix by: Nea
Someone To You by: BANNERS
Someone You Loved by: Lewis Capaldi
Something Just Like This by: The Chainsmokers
Star Shopping by: Lil Peep
Still Don't Know My Name by: Labrinth
Stuck with U (with Justin Bieber) by: Ariana Grande
Stunnin' (feat. Harm Franklin) by: Curtis Waters
Sunday Best by: Surfaces
Sunflower - Spider-Man: Into the Spider-Verse by: Post Malone
Supalonely by: BENEE
Sweater Weather by: The Neighbourhood
Sweet but Psycho by: Ava Max
Tak Tiki Tak by: Harry Nach
Take Me To Church by: Hozier
Take You Dancing by: Jason Derulo
Tap In by: Saweetie
Tap In (feat. Post Malone, DaBaby & Jack Harlow) by: Saweetie
Tattoo - Remix with Camilo by: Rauw Alejandro
